
  1TTTTT2    1TTTTTTTTTTTT2
  L00000R    L000000000000R
  L00000R    L000000000000R
  L0S000D    D000000000000R
  L00000R    L0005BBBB6000R
  L00000R    L000R    L000R
  3BBBBB4    L000R    L000R
             L000R    L000R
             L000R    L000R
             L0007TTTT8000R
             L000000000000R
             L000000000000R
             L000000000000R
             3BBBBBBBBBBBB4